Aphex Twin - Selected Ambient Works 85-92
Ween - Chocolate and Cheese
Lauryn Hill - The Miseducation of Lauryn Hill
Michael Jackson - Thriller
Daft Punk - Discovery
Emperor - In the Nightside Eclipse
Tom Waits - Rain Dogs
Talking Heads - Remain In Light
Outkast - ATLiens
Captain Beefheart - Trout Mask Replica
David Bowie - The Rise and Fall of Ziggy Stardust and the Spiders from Mars
The Microphones - The Glow Pt. 2
Yes - Close to the Edge
Nirvana - In Utero
Nas - Illmatic
Patti Smith - Horses
Radiohead - Kid A
DJ Shadow - Endtroducing.....
N.W.A. - Straight Outta Compton
Slint - Spiderland
Bob Dylan - Highway 61 Revisited
Tangerine Dream - Phaedra
Roland Kirk - I Talk With the Spirits
Kate Bush - Hounds of Love
Iron Maiden - The Number of the Beast
Kraftwerk - Trans-Europe Express
A Tribe Called Quest- The Low End Theory
Joy Division - Unknown Pleasures
Nina Simone - Pastel Blues
Prince and the Revolution - Purple Rain
Fugazi - Repeater
Johnny Cash - At Folsom Prison
The Velvet Underground & Nico - Self-Titled
Miles Davis- Bitches Brew
My Bloody Valentine- Loveless
King Crimson- In the Court of the Crimson King
Dead Kennedys- Plastic Surgery Disasters
Madvillain- Madvillainy
Neutral Milk Hotel - In the Aeroplane Over the Sea
Marvin Gaye- What's Going On
Wu-Tang Clan- Enter the Wu-Tang: 36 Chambers
Frank Zappa- Hot Rats
Godspeed You! Black Emperor- Lift Yr. Skinny Fists Like Antennas to Heaven!
